连脑疼痛	头	头脑疼痛
长流冷泪	目	流冷泪
头痛恶寒	皮	恶寒
腹痛烦热	皮	烦热
畏寒加衣	皮	畏寒
面削色晄白泛青色	肉	面削
眠差口干	口	口干
伴有脘腹胀满	腹	脘腹胀满
性情烦躁	情绪	性情烦躁
嘈杂冲逆	运化	嘈杂
两胁刺痛,灼热	皮	身灼热
行走乏力	肉	乏力
右手指端麻木	皮	指端麻木
语声低微	神志	语声低微
咳吐浊唾涎沫	运化	吐
眼泪自流	目	眼泪自流
手足厥冷	皮	手足厥冷
赤带	泌尿生殖	赤带
乳汁不足	乳房	乳汁不足
经前胃胀	腹	胃胀
咽喉部干痒	皮	痒
神疲体倦	肉	体倦
腰酸腿酸	肉	腿酸
有时胃痛	腹	胃痛
皮肤枯干	皮	皮肤干枯
汗出清稀	皮	汗出
纳差经期提前	泌尿生殖	经期提前
失血而呕逆肢冷	运化	呕逆
头晕耳鸣	耳	耳鸣
筋急口噤	口	口噤
晨起眼睑微肿	骨	肿
腰背活动受限	肉	活动受限
喉咽痛唾脓血	咽喉	喉咽痛
著惊发热	皮	发热
左侧颈肩疼痛	肉	颈肩疼痛
头晕乏力	头	头晕
月经量少色红	泌尿生殖	月经量少
痛时不敢活动失眠纳差	运化	纳差
大便干结不畅	运化	大便干结
目不能睁	目	目不能睁
心慌时有发作	胸	心慌
咽干口苦	口	口苦
右上肢不能抬举	肉	右上肢不能抬举
汗多不止	皮	汗多
腰脊痛	腰	腰脊痛
腰痛甚	腰	腰痛
目昏	目	目昏
腹痛泄后可缓解	腹	腹痛
面黄身倦	皮	面黄
嗳气后痞满觉舒	运化	嗳气
胃中时有嘈杂感	运化	嘈杂
时有胸闷痛	胸	胸闷
伴烦躁	情绪	烦躁
口干苦粘	口	口干
心易烦躁	情绪	烦躁
心慌烦躁	胸	心慌
微咳	呼吸	咳
多唾食少	运化	食少
脉沉	脉	脉沉
尿道口痒	皮	痒
胃中胀满不适	腹	胃中胀满
胸膈坚满	胸	胸膈满
眼睑和双下肢浮肿	皮	双下肢浮肿
双背肩痛	肉	背肩痛
喘哮痰鸣	咽喉	痰鸣
运动后脚肿	皮	脚肿
瘙痒大便干	运化	大便干
口渴腹痛	腹	腹痛
胃痛食少	运化	食少
夜间恶心	运化	恶心
经前烦躁	情绪	烦躁
体虚乏力	肉	乏力
大便粘腻	运化	大便粘
大汗及恶心	皮	大汗
胃脘痛隐痛	腹	胃脘痛
按之腹痛稍减	腹	腹痛
剑突至脐上痛甚	腹	脐上痛
小儿四肢肿满	皮	四肢肿满
咳不止	呼吸	咳
夜睡不安	神志	夜睡不安
多梦头重	头	头重
手足心轻微发热	皮	发热
目前仍咽痛	咽喉	咽痛
微有恶寒	皮	恶寒
胃饱胀感	腹	胃饱胀
易惊善忘	情绪	易惊
体胖	肉	体胖
身热骨酸	肉	骨酸
四肢皮肤出现大量出血点	皮	四肢
咳吐暗红色痰	呼吸	咳
倦怠腹胀	肉	倦怠
头痛时左手麻木	头	头痛
腹痛明显	腹	腹痛
热退时有汗	皮	汗
喉中哮鸣	咽喉	喉中哮鸣
午后神疲	神志	神疲
白带量多色白质清稀	泌尿生殖	白带
平时怕冷	皮	怕冷
右侧上下肢乏力	肉	乏力
两脚筋挛	筋	筋挛
中风口噤不能言	口	口噤
胸脘闷塞	腹	脘闷塞
多梦大便干溏不调小便黄	神志	多梦
巩膜皮肤发黄	目	巩膜皮肤发黄
左上肢不能活动	肉	不能活动
尿黄	泌尿生殖	尿黄
体重头痛	头	头痛
耳鸣腰痛	腰	腰痛
鼻塞涕多	鼻	鼻塞
眠梦多大便干	神志	梦多
尿白如米泔	泌尿生殖	尿白
时有咽痛	咽喉	咽痛
腰酸形寒	腰	腰酸
神情烦躁	情绪	烦躁
抽筋手足疼	筋	抽筋
恶心头晕	运化	恶心
周身觉冷	皮	冷
久站腰酸隐痛	腰	腰酸
肩背麻木	皮	肩背麻木
溲少便结	运化	便结
右胁下疼痛	胁	右胁下疼痛
颊赤口渴	皮	颊赤
双下肢酸软无力	肉	无力
双侧下腹隐痛	腹	下腹隐痛
感冒后感头昏重	头	头昏
遍身肿满	皮	遍身肿满
鼻塞头痛	鼻	鼻塞
目瞪唇青	口	唇青
牙关不能开	口	牙关不开
小便闭结	泌尿生殖	小便闭结
头胀痛（枕后疼痛）	头	头胀
双下肢水肿伴头晕	头	头晕
夜不安眠	神志	夜眠不安
低热咳嗽	呼吸	咳嗽
外阴潮湿瘙痒腰膝痠软	皮	瘙痒
胸闷背胀	胸	胸闷
双下肢发凉疼痛	皮	发凉
双眼畏光	目	畏光
发咳呕涎	运化	呕吐涎
心慌等症	胸	心慌
令人四肢挛急	筋	四肢挛急
呃逆频作	运化	呃逆
斑片状出现下肢浮肿刻下腰膝酸软	皮	下肢浮肿
足胫寒冷	皮	足胫寒
小便短赤(曾有过瘀黑色大便)	泌尿生殖	小便短
左侧肢体活动不灵	肉	左侧肢体活动不灵
规则阴道流血	生殖器	阴道流血
大便干秘	运化	大便干秘
神软倦怠	肉	倦怠
经行腰酸明显	腰	腰酸
左髋关节疼痛	骨	左髋关节疼痛
口干舌燥	口	口干
小便失禁	泌尿生殖	小便失禁
腹痛拒按而喜热敷	腹	腹痛
颜面晄白	皮	颜面
口干渴	口	口干渴
小腿肿	皮	小腿肿
左面部麻木	皮	左面部麻木
肉食后感觉胃脘痞满不适	腹	胃脘痞满
汗出很多	皮	汗出
怕凉喜暖	皮	怕凉
身目黄染	目	目黄染
食少神疲	神志	神疲
头痛时作	头	头痛
下夜睡眠差	神志	睡眠差
口渴喜热饮	运化	喜热饮
胁下有痞	胁	胁痞
面黄无泽	皮	面黄
见肢体关节疼痛	骨	肢体关节疼痛
腰脊痠痛	腰	腰脊痠
手足发热	皮	手足发热
头抽动	筋	抽动
纳差寐差	神志	寐差
目涩头晕	头	头晕
爪甲稍青	筋	爪甲青
恶风畏寒	皮	畏寒
胸闷善太息	胸	胸闷
肛门坠胀不适	肛门	肛门坠胀
肋间疼痛	胁	肋间疼痛
婚后6年未孕	泌尿生殖	未孕
眼花目眩	目	目眩花
右附件包块	皮	包块
产后50天阴道流血不净	生殖器	阴道流血
胃脘胀闷热灼	腹	胃脘胀
腹中水响	腹	腹响
口干不欲	口	口干
偶有便血	运化	便血
心烦乏气	情绪	心烦
经行小腹坠胀冷痛	腹	小腹坠
身倦无力	肉	身倦无力
腹痛并有灼热感	腹	腹痛
伴有脑鸣	耳	脑鸣
排卵期少腹痛	腹	少腹痛
心痛腹胀	胸	心痛
右足末端麻木	皮	麻木
轻度水肿	皮	水肿
腹肋胀满	腹	腹满胀
面赤口干渴欲饮	皮	面赤
胁下气逆满闷	胁	胁满闷
胸部刺痛	胸	胸部刺痛
四肢酸痛	皮	四肢
阴茎及阴囊上缩	生殖器	阴囊上缩
量少伴腰痠腹痛	腰	腰痠
有时泛酸	运化	泛酸
睡醒后心慌	胸	心慌
眠差盗汗	神志	眠差
忧郁	情绪	忧郁
心中卒痛	胸	心中痛
饱塞于上脘	腹	脘塞
右耳鸣响如风声	耳	右耳鸣响
腹胀疼	腹	腹胀
右胁灼热不适	胁	胁灼热
腰疼背痛.	腰	腰疼
时有大腿疼	肉	大腿疼
胸闷乏力	胸	胸闷
低热头昏痛	头	头昏
胃腑作痛	腹	胃腑痛
下腹隐痛感	腹	下腹隐痛
自汗神倦	皮	自汗
常腰酸	腰	腰酸
肛门坠胀精神疲乏	肛门	肛门坠胀
闭目露睛	目	闭目
感冒后咳嗽	呼吸	咳嗽
眼颤	目	眼颤
拘急	筋	拘急
脱发明显	皮	脱发
头晕发热	皮	发热
故多惊恐	情绪	多惊恐
汗出后可热退	皮	汗出
口唇及指甲青紫	筋	指甲青紫
现停经近58天	泌尿生殖	停经
口苦溲黄	口	口苦
粘液血便	运化	血便
汗出较多	皮	汗出
喷嚏时胁肋疼痛	鼻	喷嚏
咽干燥作痛	咽喉	咽干燥
腹部怕凉	皮	怕凉
头疼脊强	头	头疼
目睛干涩较甚	目	睛干涩
头疼腰重	腰	腰重
左半身乏力	肉	乏力
每发则头晕	头	头晕
口渴心烦	情绪	心烦
腹胀纳少	运化	纳少
手麻胀	皮	手麻
咳灰色粘痰	呼吸	咳
大便干小便黄	运化	大便干
烦热不寐	神志	不寐
咳嗽痰鸣	咽喉	痰鸣
夜间心慌	胸	心慌
气促胸闷	胸	胸闷
有痰鸣音	咽喉	痰鸣
发烧嘶哑	皮	发烧
双下肢怕凉	皮	怕凉
头痛身疼	头	头痛疼
大便干结不调	运化	大便干结
乏力皮肤黄染	肉	乏力
双手颤动萎缩	筋	双手颤动
小便黄赤多泡沫	泌尿生殖	小便黄赤
偶有腹胀	腹	腹胀
四肢厥冷	皮	四肢厥冷
肌瘦盗汗	肉	肌瘦
醒后难入眠	神志	难入眠
腰部剧痛	腰	腰部剧痛
咳逆	呼吸	咳逆
鼻塞不通	鼻	鼻塞不通
头痛且昏	头	头痛
声息低微	神志	声息低微
大便溏薄	运化	大便溏薄
不能平卧大便不通情绪急躁焦虑无法入睡形体较瘦	情绪	情绪急躁
头痛身痛	头	头痛
烦恼	情绪	烦恼
心怔烦闷	情绪	烦闷
牙龈多处溃疡面腹胀	腹	腹胀
稍有抽动	筋	抽动
头昏目花	头	头昏
胃部疼痛不适	腹	胃部疼痛
腹痛不休	腹	腹痛
伴右侧肢体麻木无力性情急躁	情绪	性情急躁
脐腹虚冷	腹	脐腹冷
身面肿满	皮	肿满
右侧面部口角歪斜	口	口角歪斜
双侧上肢麻木	皮	上肢麻木
多则腹胀	腹	腹胀
烦躁脉紧而弦	脉	脉紧
患者体形胖	肉	体形胖
体质消瘦	肉	体质消瘦
背心发凉	皮	发凉
但欲寐	神志	但欲寐
排尿次数增多	泌尿生殖	排尿次数增多
心悸气促	呼吸	气促
经色淡黯有血块	泌尿生殖	经色淡黯
便滞	运化	便滞
爱生气	情绪	爱生气
少腹作胀	腹	少腹作胀
咽痒声嘶	咽喉	咽痒
自幼遗尿	泌尿生殖	遗尿
声低懒言	神志	声低
尿多	泌尿生殖	尿多
咳嗽有白痰	呼吸	咳嗽
经量少血色黯淡	泌尿生殖	经量少
双下肢小腿浮肿	皮	小腿浮肿
胸膜转移咳嗽	呼吸	咳嗽
失眼盗汗	皮	盗汗
汗下脉虚	脉	脉虚
手颤不能握物	筋	手颤
时有小便自遗	泌尿生殖	小便自遗
感冒咳嗽	呼吸	咳嗽
体格肥胖	肉	体格肥胖
腹痛分泌物多	腹	腹痛
乏力怕冷	皮	怕冷
口干夜晚明显	口	口干
绝经后阴道出血	生殖器	阴道出血
时有大便稀溏	运化	大便稀溏
头紧痛	头	头紧痛
吞咽反射迟钝	神志	迟钝
上肢痠困沉麻木	皮	麻木
有时肩背部疼痛	肉	肩背部疼痛
小便黄.	泌尿生殖	小便黄
便溏肢倦	运化	便溏
神乏体倦	肉	体倦
呕吐后腹痛无减轻	运化	呕吐
表面附有糠皮状鳞屑舌质红	舌	舌质红
咽喉干痛与塞	咽喉	咽喉干
右侧上腹部扪及质软包块	皮	包块
行步艰辛及筋脉拳挛	筋	筋挛
发渴烦热	口	发渴
小便泡沫	泌尿生殖	小便泡沫
咳而遗尿	泌尿生殖	遗尿
咳少量痰	呼吸	咳
感胸闷咽痒	咽喉	咽痒
努挣乏力	肉	乏力
鼻塞不闻臭香	鼻	鼻塞
足胫肿重无力	肉	无力
发热时足冷	皮	足冷
白带量多色白	泌尿生殖	白带量多
肚胀腹满	腹	腹满胀
心烦吵啼	情绪	心烦
小便频数色黄余沥不尽	泌尿生殖	小便频数
颈肩痛麻木	皮	麻木
心累心悸	胸	心悸
偶有抽搐现象	筋	抽搐
心悸时作	胸	心悸
上腹部疼痛不适	腹	上腹部疼痛
有时溏泻	运化	溏泻
烦热不寐	皮	烦热
阵发性头痛	头	头痛
小腹冷隐痛	腹	小腹冷
高热烦渴	皮	高热
口干舌燥	口	口干
情志不畅易吐血	运化	吐血
头痛心烦	情绪	心烦
活动后气喘	呼吸	气喘
食欲欠佳	运化	食欲欠佳
眼胞浮肿	皮	眼胞浮肿
带下黄腻	泌尿生殖	带下黄
眩晕耳鸣.	耳	耳鸣
伴有头晕	头	头晕
晨起即觉重度腰痛	腰	腰痛
反复颜面及双下肢浮肿	皮	颜面及双下肢浮肿
头部麻木	皮	头部麻木
食后困倦	肉	困倦
且感胸闷气短	胸	胸闷
小儿骨热体瘦	肉	体瘦
伴双下肢无力	肉	双下肢无力
颈项疼痛连及后背	肉	颈项疼痛
咳嗽轻微	呼吸	咳嗽
植物神经病变治疗无显效求中医诊治刻下：口渴欲饮	口	口渴
四肢酸软无力	肉	无力
继而发热	皮	发热
腹肿如鼓	皮	腹肿
臀部疼痛	肉	臀部疼痛
臂疼胁痛	胁	胁痛
口干不喜饮	口	口干
全身发黄	皮	全身发黄
述头晕乏力	肉	乏力
矢气好转	运化	矢气
语言謇涩	神志	语言謇涩
腰痠膝软	肉	膝软
胸脘烦热感	皮	烦热
体热多涎	口	多涎
右胁肋痛	胁	右胁肋痛
经期短	泌尿生殖	经期短
劳累后疲惫	肉	疲惫
阴道流血多	生殖器	阴道流血
腹大肌瘦	腹	腹大
夜梦纷坛	神志	夜梦纷坛
溺黄	泌尿生殖	溺黄
吐痰色白而粘	运化	吐痰
稀溏便	运化	稀溏便
咽痛轻微头痛	咽喉	咽痛
头汗自出	皮	头汗
倍感疲乏	肉	疲乏
胀满大腹	腹	大腹胀满
暗耗阴血所致的面色萎黄	皮	面色萎黄
晨僵畏寒	皮	畏寒
伴怕冷	皮	怕冷
口淡时吐涎末	运化	吐涎
吐痰色白	运化	吐痰
口苦头昏	头	头昏
倦卧肢凉	皮	肢凉
右胁隐痛并放射至后背	胁	右胁隐痛
头剧痛	头	头剧痛
腰痛剧烈	腰	腰痛
耳中憋气	耳	耳中憋气
二便少	运化	便少
双下肢针刺感  头晕	头	头晕
咳吐脓痰	呼吸	咳
腰痠头晕	头	头晕
腰冷	腰	腰冷
腹痛腰痛	腹	腹痛
小腹胀满饮食	腹	小腹胀满
头晕欲寐	头	头晕
右眼突出	目	右眼突出
左眼结膜充血	目	左眼结膜充血
咳则腿发抖	呼吸	咳
舌稍红	舌	舌稍红
皮肤红斑脱屑瘙痒	皮	瘙痒
带黄有臭味	泌尿生殖	带黄
胞睑浮肿	骨	浮肿
痛如锥刺心烦健忘	情绪	心烦
腹痛且凉	腹	腹痛
纳少身疲	运化	纳少
频咳	呼吸	咳
身沉乏力	肉	乏力
下腹胀坠痛	腹	下腹胀
神差倦怠白带偏多	泌尿生殖	白带
颊赤头痛	皮	颊赤
脘部胀满或疼痛	腹	脘部胀满
心烦盗汗	皮	盗汗
口噤神昏	口	口噤
排尿灼热	泌尿生殖	排尿灼热
胸闷脘痞	腹	脘痞
睾丸抽痛	生殖器	睾丸抽痛
小儿热积胃中	腹	胃中热
颈部疼痛发硬	肉	颈部疼痛
肢痛面黄	皮	面黄
烦热口渴.	皮	烦热
时有腿部抽筋	筋	抽筋
困倦嗜睡	肉	困倦
久不合口	口	口不合
肛门瘙痒潮湿	肛门	肛门瘙痒
焦躁不安	情绪	焦躁
手汗出	皮	手汗出
吐痰量多粘稠	运化	吐痰
甚则胸闷泛恶	胸	胸闷
腰酸腹痛	腰	腰酸
冷热泪下	目	泪下
伴有大便溏薄	运化	大便溏薄
白天精神差	神志	精神差
腰酸膝软	肉	膝软
倦怠嗜睡	神志	嗜睡
腰痠耳鸣	耳	耳鸣
腰部及双下肢发凉	皮	发凉
眼涩口噤	口	口噤
憎寒头痛	皮	憎寒
热前畏寒	皮	畏寒
枕区头发脱落	皮	头发脱落
走路跛行	肉	走路跛行
身软神疲	神志	神疲
行动不便	肉	行动不便
身体壮热头痛	头	头痛
晨起身痛	肉	身痛
腹大青筋	脉	肚大青筋
活动后腰痛减轻右小腿麻木	皮	麻木
胸中犹隐隐痛	胸	胸中隐隐痛
右手颤抖	筋	右手颤抖
双目干涩刻下症见双小腿浮肿	皮	小腿浮肿
眼睑痒极	目	眼睑痒
劳累后左下肢疼痛麻木	肉	左下肢疼痛
脘腹隐痛嘈杂	运化	嘈杂
小便多	泌尿生殖	小便多
头晕反复发作2006-1-11头晕持续20分钟不能缓解	头	头晕
黑苔	舌	黑苔
大汗淋漓头面如洗	皮	大汗淋漓
眼睑烂痒	目	眼睑痒
胃脘疼痛不适	腹	胃脘疼痛
自觉瘙痒	皮	瘙痒
腹痛乏力	腹	腹痛
左胁胀闷	胁	左胁胀
周身无力 心悸眠差	胸	心悸
腰胀腹胀	腰	腰胀
小儿腹大羸瘦	肉	羸瘦
发热口渴	皮	发热
四肢消瘦	肉	四肢消瘦
体倦盗汗	肉	体倦
神衰力弱	肉	力弱
或伴气短乏力	呼吸	气短
痰涎喉痹	咽喉	喉痰
胸中郁痛	胸	胸中痛
后背疼	肉	后背疼
有鼻塞	鼻	鼻塞
痰量少带血	泌尿生殖	带血
小便短少色深	泌尿生殖	小便短少
多食即腹胀	腹	腹胀
双眼痒	皮	痒
上下肢单侧乏力	肉	乏力
尿少	泌尿生殖	尿少
小儿骨瘦面黄	肉	骨瘦
尿赤发热	皮	发热
头晕眼黑	头	头晕
舌赤神昏	舌	舌赤
头晕口干	头	头晕
午后夜间易出汗	皮	出汗
左側颜面麻木	皮	颜面麻木
鼻不闻香臭	鼻	不闻香臭
阴道出血淋漓不净	生殖器	阴道出血
偶有外阴瘙痒	生殖器	外阴瘙痒
阵作胸闷疼痛	胸	胸闷
咽干口渴喜饮	咽喉	咽干
哕	运化	哕
食后胃脘隐痛	腹	胃脘隐痛
颜面眼睑浮肿	皮	颜面眼睑浮肿
双侧腹股沟淋巴结肿大如枣	皮	淋巴结肿大
大便溏.	运化	大便溏
伴面部浮肿	皮	面部浮肿
心烦少寐	情绪	心烦
心烦失眠	神志	失眠
烦躁多梦	神志	多梦
运动即出汗多	皮	出汗
屈伸活动受限	肉	活动受限
伴口苦咽干	口	口苦
壮热咳嗽	呼吸	咳嗽
嗅觉差	鼻	嗅觉差
伴有胸闷胁胀	胸	胸闷
咽喉瘙痒	咽喉	咽喉瘙痒
身体肥胖	肉	身体肥胖
经前心烦	情绪	心烦
腰骶冷胀不适	腰	腰骶冷
肛裂出血	肛门	肛裂
项强痛	筋	项强
后背皮肤出现搔痒	皮	搔痒
夜间喘促	呼吸	喘促
头痛身体壮热	头	头痛
腹部胀满坠痛不适	腹	腹部胀满
额前痛连眼眶	头	额前痛
腹部剧痛	腹	腹部剧痛
心烦面垢	情绪	心烦
大便难解.	运化	大便难解
胃纳不佳	运化	胃纳不佳
间断腹痛	腹	腹痛
自汗乏力	皮	自汗
带黄粘稠	泌尿生殖	带黄
而脉息无力	脉	脉息无力
溲不畅	泌尿生殖	溲不畅
时便出粘液	运化	便出粘液
腰痠如折怕冷	腰	腰痠
滑精遗精	泌尿生殖	遗精
眼睑四肢浮肿	皮	四肢浮肿
脘闷纳呆	腹	脘闷
精神困倦	神志	精神困倦
伴以头脑昏沉偶然双耳憋气	呼吸	憋气
多疑妄听	情绪	多疑
心慌等不适	胸	心慌
睡眠梦多	神志	梦多
小便色黄染尿布	泌尿生殖	小便色黄
痰多口粘	口	口粘
喉间痰鸣音	咽喉	喉间痰鸣
曾有肉眼血尿	泌尿生殖	血尿
平素性情急躁	情绪	性情急躁
唇红干	口	唇红
腰痛及左下肢疼痛	肉	左下肢疼痛
伴下腹部胀满不适	腹	下腹部胀满
背腰冷痛睡眠欠安	神志	睡眠欠安
以致脑筋转拧疼痛	头	脑痛
咳大量黄痰	呼吸	咳
刻下头痛	头	头痛
进食后腹痛	腹	腹痛
食后上腹胀	腹	上腹胀
项背强痛	筋	项背强
上腭部痒	皮	痒
时有恶寒.	皮	恶寒
长喜叹气	情绪	叹气
心痛	胸	心痛
行路不稳	肉	行路不稳
足尖不能活动	肉	不能活动
口干溲赤	泌尿生殖	溲赤
全身伴有气短乏力	肉	乏力
饮后泛恶	运化	泛恶
耳鸣腰酸腿软	腰	腰酸
尿频	泌尿生殖	尿频
尿黄赤	泌尿生殖	尿黄赤
血糖控制一般2年前无明显诱因出现胸闷气短	呼吸	气短
脘胁胀痛	胁	胁胀
眠不安	神志	眠不安
外阴轻微瘙痒	皮	瘙痒
便溏泄泻	运化	便溏泄
腹灼热辣痛	腹	腹灼热
趾端麻木	皮	麻木
左半身及双目发凉	皮	发凉
伴活动不利	肉	活动不利
下纯红色粘滞的血便	运化	血便
喜静恶动	情绪	喜静恶动
伴颜面	皮	颜面
时觉口苦	口	口苦
心热发惊	情绪	发惊
小儿骨热肌瘦	肉	肌瘦
面色萎黄少泽	皮	面色萎黄
术后阴道流血30余天不净	生殖器	阴道流血
阴道瘙痒	生殖器	阴道瘙痒
左臂痛	肉	左臂痛
心痛反复发作	胸	心痛
身体壮热	皮	身体壮热
眼干左膝疼	目	眼干
吐痰涎及胃内容物	运化	吐痰涎
或痰粘成块	皮	痰块
两肋胀满	胁	两肋胀满
已婚未孕困倦乏力纳主食少	肉	困倦乏力
心前区疼痛伴闷压紧缩感	胸	心前区疼痛
右侧 肢体无力且疼痛	肉	肢体无力
咳时头痛	头	头痛
胸部紧闷	胸	胸紧闷
红斑结节	皮	结节
尿液混浊	泌尿生殖	尿液混浊
面黄身倦	肉	身倦
右膝酸困无力	肉	无力
左躯干部皮肤潮红起疱	皮	皮肤潮红
晨起时咳嗽	呼吸	咳嗽
大便干燥.	运化	大便干燥
胸闷气短小腹冷痛牵及腰骶部痠痛坠	呼吸	气短
烘热出汗	皮	出汗
不喜言语	情绪	不喜言语
咳嗽则恶心想吐	运化	恶心
左半侧肢体发凉	皮	发凉
咳甚尿出	呼吸	咳
咳嗽间作	呼吸	咳嗽
痰多咳甚	呼吸	咳
自觉怕冷	皮	怕冷
头晕呕吐	运化	呕吐
疲劳乏力	肉	疲劳乏力
腹痛便溏涕多色黄有稀有稠睡时有鼾声	运化	便溏
血从牙缝流出	骨	牙缝出血
口臭肌热	口	口臭
咳嗽痰多粘腻色白	呼吸	咳嗽
乏力身重	肉	乏力
头晕头颈转动则加剧	头	头晕
颈肩部疼痛不适	肉	肩部疼痛
口苦急躁	口	口苦
体热心惊	皮	体热
吐血崩漏	泌尿生殖	漏尿
心悸气短	胸	心悸
面红目赤	目	目赤
畏光干涩	目	畏光
腹痛心烦	情绪	心烦
伴记忆力下降	神志	记忆力下降
神情淡漠	神志	神情淡漠
唇舌部震颤麻木	筋	震颤
厌食	运化	厌食
双手拇食中指麻木	皮	中指麻木
苔黄	舌	苔黄
牙齿虫疼痛	骨	牙齿疼痛
痛连于脑	头	脑痛
口干苦.	口	口干
头痛微汗	头	头痛
便溏腹痛	腹	腹痛
胸闷痰黄稠	胸	胸闷
二便调曾有潮热	皮	潮热
迈步行走困难	肉	行走困难
头晕腹痛	头	头晕
自觉低热	皮	低热
双腿侧筋抽痛	筋	筋抽
头晕心宕	胸	心宕
伴烧心泛酸	运化	泛酸
腿疼麻木	肉	腿疼
面黑耳枯	皮	面黑
面色白透晦暗	皮	面色白
怯冷	皮	怯冷
左上肢肿明显	皮	左上肢肿
睡眠精神差.	神志	精神差
大便稀溏	运化	大便稀溏
身倦	肉	身倦
肛门下坠感	肛门	肛门下坠
一身发黄	皮	一身发黄
腰痠并冷	皮	冷
风团瘙痒	皮	瘙痒
小肠撮痛	腹	肠痛
毛发不泽	皮	毛发不泽
背部疼痛	肉	背部疼痛
神识不清	神志	神识不清
活动后易汗出	皮	汗出
心动悸	胸	心动悸
夜间醒来汗多	皮	汗多
吐舌咂嘴	舌	吐舌
咳嗽咯白粘咸痰	呼吸	咳嗽
颊赤唇焦	皮	颊赤
阴部胀闷	生殖器	阴部胀
易头晕	头	头晕
齿龈出血	骨	齿龈出血
经常出汗	皮	出汗
双侧臀腿疼痛	肉	腿疼痛
尿短	泌尿生殖	尿短
形体畏寒	皮	畏寒
关内芤脉	脉	关脉芤
眼生胬肉侵睛	目	眼生胬肉
睡则多梦	神志	多梦
纳呆神疲	神志	神疲
肌肉疼痛明显	肉	肌肉疼痛
形瘦	肉	形瘦
心烦口干.	情绪	心烦
咳甚则吐咽痒	咽喉	咽痒
胆怯失眠	神志	失眠
胃脘隐痛灼热	腹	胃脘隐痛
咳痰量多质稠	呼吸	咳痰
有时白带酱色带并臭秽	泌尿生殖	白带
晨起尿黄	泌尿生殖	尿黄
偶有情绪烦躁	情绪	烦躁
双小腿酸胀乏力	肉	乏力
动则汗出纳差	皮	汗出
唇白面黄	口	唇白
腹痛多渴	口	口渴
手足冷.	皮	手足冷
汗液发粘	皮	汗液
遗精便浊	泌尿生殖	便浊精遗
心累气短	呼吸	气短
眼冒金星	目	眼冒金星
怯冷腰酸	腰	腰酸
胁痛不适	胁	胁痛
左侧颈项强痛	筋	颈项强
尿频数而痛	泌尿生殖	尿频数
心慌多汗	胸	心慌
吐血并嗽血	呼吸	嗽血
脉濡	脉	脉濡
经前肿块增大	皮	肿块
心下满胀	腹	心下满胀
气短声低	神志	声低
浮肿乏力	肉	乏力
多汗肢软	肉	肢软
肢体倦怠	肉	肢体倦怠
平素便溏	运化	便溏
无力排便	肉	无力
运动障碍	肉	运动障碍
头痛颊赤	皮	颊赤
便后腹痛减轻	腹	腹痛
咳嗽有痰色黄	呼吸	咳嗽
颈软无力	肉	无力
手关节痛	骨	手关节痛
双侧甲状腺肿大	皮	甲状腺肿大
咽干耳鸣	咽喉	咽干
燥屎存于腹内作痛	运化	燥屎
头痛痛以两侧为著	头	头痛
低热二年	皮	低热
少腹挟寒	腹	少腹寒
头重眩晕	头	头重
行动受限	肉	行动受限
左腕疼痛略肿	骨	肿
双下肢指凹性水肿	皮	水肿
并牵引少腹坠胀不舒	腹	少腹坠
焦虑多汗	皮	多汗
脘胁疼痛	肉	胁疼痛
偏食	运化	偏食
患偏头疼	头	偏头疼
额汗自出	皮	额汗
咳而遗尿	呼吸	咳
间断性失眠	神志	失眠
眠不实	神志	眠不实
彻夜不寐	神志	彻夜不寐
力乏气促	呼吸	气促
伴有咳嗽	呼吸	咳嗽
舌红	舌	舌红
反复乏力	肉	乏力
盗汗腹痛	腹	腹痛
晨起时咳粘稠黄痰	呼吸	咳
不渴	口	不渴
流黄涕	鼻	流黄涕
背部发凉	皮	背部发凉
伴头晕乏力	肉	乏力
腹部及腰背部疼痛	肉	背部疼痛
嗳气腹胀	运化	嗳气
食纳乏味	运化	食纳乏味
呕吐食物及苦水	运化	呕吐
哭笑无常	神志	哭笑无常
左侧肢体麻木	皮	左侧肢体麻木
双下肢皮肤瘙痒	皮	皮肤瘙痒
腰酸且痛	腰	腰酸
口苦耳鸣	耳	耳鸣
痰多咳吐不爽	运化	吐
气促,体温反低	呼吸	气促
经期少腹作痛	腹	少腹作痛
伴弯腰活动受限	肉	活动受限
下肢胀	肉	下肢胀
足冷口噤	皮	足冷
腹中有物状包块	皮	包块
晨起咳痰	呼吸	咳痰
头痛呈持续性疼痛	头	头痛
阴痿阴汗	泌尿生殖	阴痿
口干失眠	神志	失眠
腰酸胀沉	腰	腰酸
肛肿	骨	肿
夜不能寐动则气喘特甚	神志	夜不能寐
肛门灼热感	肛门	肛门灼热
经来腹痛伴经前乳胀	腹	腹痛
鼻干口渴欲饮	鼻	鼻干
腹泻腹痛	腹	腹痛
烦热	皮	烦热
右足趾麻木	皮	麻木
欲嗳气而不能	运化	嗳气
双手胀麻	口	麻
曾有发热	皮	发热
腹泻肠鸣而急痛	腹	肠鸣
腹大筋青	脉	肚大筋青
中脘宿冷	腹	脘冷
睡卧不安胃膈闷满	神志	睡卧不安
少气乏力	肉	乏力
右胁部胀闷不适	胁	右胁部胀
腹痛呃逆	运化	呃逆
胸闷易怒	情绪	易怒
伴小腹痛	腹	小腹痛
反复腰酸乏力	肉	乏力
全身肌肉疼痛	肉	全身肌肉疼痛
腰骶酸困痛	腰	腰骶酸
肿块	皮	肿块
胃疼	腹	胃疼
喘躁眼赤	目	眼赤
唇甲青紫	筋	甲青紫
腹内刺痛	腹	腹痛
腹痛膝软	腹	腹痛
偶有泛酸烧心	运化	泛酸
经前腰胀	腰	腰胀
磨牙吐弄舌	舌	吐弄舌
排尿点滴乏力	肉	乏力
便秘溲赤	泌尿生殖	溲赤
有肩背部抽掣痛	筋	抽掣
伴有胸闷腹胀	胸	胸闷
疲倦.	肉	疲倦
咳如痉	呼吸	咳
失音	神志	失音
口干苦欲饮	口	口干
不思食	运化	不思食
带有咳嗽	呼吸	咳嗽
身体稍消瘦	肉	消瘦
面萎黄	皮	面萎黄
嗳气时轻时重	运化	嗳气
四肢厥冷腰酸	皮	四肢厥冷
神软乏力	肉	乏力
左侧胸前区疼痛	胸	胸前区疼痛
胸闷气闭	胸	胸闷
脘胁胀满	胁	胁胀满
狂嚏不止	鼻	嚏
空腹嘈痛喜按	运化	嘈
牙根浮动头晕腰痛	骨	牙根浮动
失眠时要服安眠药才能入睡	神志	失眠
伴屈伸不利	肉	屈伸不利
腹痛泻痢	运化	泄泻
头发干枯	皮	头发干枯
热退后汗出	皮	汗出
偶有粘液便	运化	粘液便
咯白粘痰胸闷	胸	胸闷
脐下疼痛	腹	脐下疼痛
行经小腹疼痛	腹	小腹疼痛
胸闷头晕	头	头晕
肛门边有核痛	肛门	肛门痛
腰酸膝凉	腰	腰酸
头痛身疼	肉	身疼痛
下肢疼痛	肉	下肢疼痛
手指尖麻	口	麻
皆缘乳汁不行	乳房	乳汁不行
大便闭结	运化	大便闭
迎风左眼流泪	目	左眼流泪
持续腹痛	腹	腹痛
脉大身热	脉	脉大
甚至举步维艰	肉	举步维艰
有时头额痛	头	头额痛
语言艰涩	神志	语言艰涩
胃部隐痛不适	腹	胃部隐痛
发烧	皮	发烧
腹臌胸闷	腹	腹臌
伴有胸痛	胸	胸痛
头痛疲乏	头	头痛
胸闷不舒,餐后即泻	运化	泄泻
便结不畅	运化	便结
左侧肢体活动欠灵活	肉	左侧肢体活动欠灵活
感乏力	肉	乏力
心烦多梦	情绪	心烦
右侧大腿沉重乏力	肉	乏力
足底麻木感	皮	麻木
嗳气夹食物味	运化	嗳气
头痛呕吐	运化	呕吐
急躁口干	情绪	急躁
头昏目赤	头	头昏
白带色黄有味	泌尿生殖	白带色黄
枕部疼痛	肉	枕部疼痛
足底发热	皮	发热
腹下坚满	腹	腹坚满
到午夜双脚不能步履	肉	不能步履
咳嗽阵阵	呼吸	咳嗽
胸痹呕恶	运化	呕恶
胃纳欠丰	运化	纳欠
呕吐哕	运化	呕哕
昏眩	目	昏眩
周身疼痛	肉	周身疼痛
月经前期腰痛更甚	泌尿生殖	月经前期
小便无力.	肉	无力
面黄清瘦	肉	清瘦
经期延长8-9天干净	泌尿生殖	经期延长
患者伴有腹胀	腹	腹胀
心忡气短	胸	心忡
以致壅塞中脘	腹	脘塞
咳嗽减轻	呼吸	咳嗽
咽喉干燥疼痛	咽喉	咽喉干燥
左乳刺痛	乳房	左乳刺痛
牙龈微肿	骨	肿
饮食俱废精神萎靡	神志	精神萎靡
耳焦枯	耳	耳焦
头晕眠差	头	头晕
午后脘痛欲呕	运化	呕
活动受限明显	肉	活动受限
全身伴见乏力	肉	乏力
口干心悸心烦	口	口干
心慌伴盗汗	胸	心慌
尿浊多泡沫	泌尿生殖	尿浊
左臀及大腿根部疼痛	肉	大腿根部疼痛
目赤气粗	呼吸	气粗
至今未孕	泌尿生殖	未孕
阴肿	生殖器	阴肿
红斑结块	皮	结块
腰痛腹坠	腹	腹坠
右胁部隐痛	胁	右胁部隐痛
胃脘胀满疼痛	腹	胃脘胀满
双下肢伸腰时麻疼	口	麻
常下腹部冷感	腹	下腹部冷
耳内闭痛	耳	耳内痛
面颌胖大	肉	胖
四肢可见大片增厚红斑	皮	四肢
咳逆喘息不得卧	呼吸	咳逆
阴部灼热干痛	生殖器	阴部灼热
口臭.	口	口臭
腹痛时作	腹	腹痛
呃逆腹痛	运化	呃逆
经行时腹坠胀甚	腹	腹坠
易出汗.	皮	出汗
办腰困乏力	肉	困乏
面白	皮	面白
盗汗流离	皮	盗汗
神识如蒙.头重如裹.	头	头重
肢体拘急	筋	肢体拘急
闭目漏隙	目	闭目
四肢颤动	筋	四肢颤动
困沉乏力	肉	乏力
胸部烦闷不适	情绪	烦闷
手足梢冷	皮	冷
伴气短乏力汗出	肉	乏力
喉内涎响	咽喉	喉响
心悸胆怯	胸	心悸
生气时即感胸脘懊憹	情绪	懊憹
左中上腹部疼痛	腹	中上腹部疼痛
伴盗汗	皮	盗汗
偶手足热	皮	手足热
两腿无力	肉	两腿无力
矢气少	运化	矢气
外阴瘙痒灼热	生殖器	外阴瘙痒
空腹痛显	腹	腹痛
胸闷不能平卧	胸	胸闷
伴经量少半年腰酸	泌尿生殖	经量少
懒食喜睡	神志	喜睡
腹胀便闭	腹	腹胀
精神弱	神志	精神弱
口干咽红	口	口干
咽干求饮不解	咽喉	咽干
牙齿宣露挺出	骨	齿宣
咳嗽少量白痰	呼吸	咳嗽
头麻	皮	头麻
头昏心慌	胸	心慌
阵发性心前区疼痛	胸	心前区疼痛
四肢酸困	肉	四肢酸
胸脘胁痛	胁	胁痛
双目发直	神志	双目发直
左侧头痛	头	左侧头痛
产后左胁胀满一块	胁	左胁胀满
颊赤口干	口	口干
髋关节疼痛	骨	髋关节疼痛
神志迟钝	神志	迟钝
肋疼	胁	肋疼
胃脘闷胀	腹	胃脘闷胀
举动不便	肉	举动不便
风热体倦	皮	体热
耳聋眼昏	耳	耳聋
耳鸣乏倦	耳	耳鸣
头晕沉闷	头	头晕
口干肚痛	口	口干
大便干欠寐.	运化	大便干
进行性发展为右上肢及肩胛部肌肉萎缩	肉	肌肉萎缩
左手浮肿	皮	左手浮肿
烦躁.汗出	情绪	烦躁
左眼睑上抬无力	肉	无力
右下腹疼	腹	右下腹疼
皮肤燥裂	皮	皮肤燥
心烦懊侬	情绪	心烦懊侬
头面四肢一经风吹	皮	四肢
腰酸软无力不适.	腰	腰酸
肢汗	皮	肢汗
伴少腹隐痛腰酸痛	腰	腰酸
诸体肉肥厚	肉	体肥厚
眼干涩感	目	眼干涩
而更兼腹痛恶食	腹	腹痛
便秘口干	口	口干
咽干吐逆	咽喉	咽干
食纳欠佳	运化	食纳欠佳
大便鲜血	运化	大便鲜血
胸膈伤痛	胸	胸膈痛
嗜冷贪凉	皮	冷
便结尿黄	泌尿生殖	尿黄
小便量多色白	泌尿生殖	小便量多
口干喜饮	口	口干
畏光疼痛	目	畏光
右手肌肉萎缩	肉	肌肉萎缩
四肢无力	肉	四肢无力
全身不自主汗出	皮	汗出
反复鼻衄	鼻	鼻衄
咳剧则呕痰涎	运化	呕
身体浮肿	皮	身体浮肿
胃脘疼痛	腹	胃脘疼痛
四末欠温	皮	四末欠温
肢软疼痛	肉	肢软
心下筑悸	胸	心下悸
形寒肢冷	皮	形寒肢冷
精滑不禁	泌尿生殖	精不禁
目眩心悸	胸	心悸
致胸膈饱满	胸	胸膈满
泛酸作呕	运化	泛酸
活动受限2年	肉	活动受限
胸闷背痛	肉	背痛
鼻塞喷涕	鼻	鼻塞
发惊搐搦	筋	搐搦
腰痛同时伴有右臀酸痛	腰	腰痛
心前区刺痛	胸	心前区刺痛
夜间排尿后出现胸痛	胸	胸痛
咽红肿痛	咽喉	咽红
出现红色皮疹腰部以下水肿	皮	水肿
面黄腹痛	皮	面黄
口唇干燥脱皮	口	口唇干燥
伴有腰酸痛	腰	腰酸
肌肤瘙痒	皮	肌肤瘙痒
恶寒甚	皮	恶寒
目暗	目	目暗
精神萎软	神志	精神萎软
前额头痛	头	前额头痛
肌热咳嗽	皮	肌热
气短心悸	呼吸	气短
脘胀反酸	腹	脘胀
胃脘疼痛时有发作	腹	胃脘疼痛
饮食差	运化	饮食差
纳呆	运化	纳呆
体痛无汗	皮	无汗
左上腹硬满疼痛	腹	腹硬满
伴头痛	头	头痛
口干欲饮	口	口干
口干多梦	神志	多梦
呕吐.	运化	呕吐
头痛作胀	头	头痛
目有昏花	目	目昏花
左上腹部疼痛	腹	左上腹部疼痛
肚腹渐大	腹	肚大
纳差小便频数	泌尿生殖	小便频数
拘挛不得俯仰	筋	拘挛
面黯	皮	面黯
轻微咽痛	咽喉	咽痛
渴而多饮	口	渴
喉间有痰流清涕睡眠欠佳	咽喉	喉间有痰
痰涌气粗	咽喉	喉痰
大腿外侧痛	肉	大腿外侧痛
口苦咽干	咽喉	咽干
梦呓	神志	梦呓
颊赤咽燥	皮	颊赤
白带增多发黄	泌尿生殖	白带增多
小腹下坠隐痛	腹	小腹下坠
小腿外侧抽筋样疼痛	筋	抽筋
下半身怕凉纳少	运化	纳少
频频脱发	皮	脱发
两下肢痛肿重	骨	肿
目珠变黄色	目	目珠黄
腰部及下肢疼痛	肉	下肢疼痛
胸满或腹痛	腹	腹痛
身汗粘润	皮	身汗
伴肠鸣	腹	肠鸣
汗出昼夜	皮	汗出
语声低却	神志	语声低
肠鸣泄痢	腹	肠鸣
乏力尿赤	泌尿生殖	尿赤
头晕腰酸	腰	腰酸
并伴有胸闷	胸	胸闷
喘促胸闷不能平卧	胸	胸闷
时有头痛	头	头痛
胃脘满闷不舒	腹	胃脘满闷
寒战高热	皮	高热
肚腹紧胀	腹	肚腹胀
喜睡	神志	喜睡
口角右偏流泪无	目	流泪
矢气后减轻	运化	矢气
汗出热不退	皮	汗出
伴食少纳呆	运化	纳呆
嘴角抽动	筋	抽动
双膝下水肿	皮	水肿
左腰部疼痛	腰	左腰部疼痛
少许口干	口	口干
则面黑手足不遂	皮	面黑
咯白色泡沫痰咽喉疼痛热则背汗出	皮	背汗出
右少腹疼痛	腹	右少腹疼痛
下颌腺肿（右）入睡难	神志	入睡难
质稀伴气短乏力	呼吸	气短
脸色晦暗	皮	脸色晦暗
白天出汗也较前增多	皮	出汗
四肢枯细	皮	四肢
右侧乳房胀及下腋痛	乳房	乳房胀
心慌发作	胸	心慌
烦躁少寐	神志	少寐
少食懒言	运化	少食
干呕头痛	运化	干呕
烦躁不能入眠	情绪	烦躁
热蕴胸膈	胸	胸膈热
小便淋漓舌质暗红苔黄腻	泌尿生殖	小便淋漓
手足心易出汗	皮	出汗
发胀麻木	皮	麻木
腰及足跟痛	肉	足跟痛
有时夜间喉间哮鸣	咽喉	喉间哮鸣
腰酸如折.	腰	腰酸
白睛混赤	目	睛赤
血尿不止伴血块	泌尿生殖	血尿
白带量多	泌尿生殖	白带量多
发热咳嗽	呼吸	咳嗽
头痛面赤	皮	头面赤
腰痠疲乏	腰	腰痠
心悸健忘	胸	心悸
鼻塞眼昏	鼻	鼻塞
夹有少量粘液．闻其气味热腐腥秽．触鼻欲呕臀部褥疮如碗大	运化	呕
稍感胸痛	胸	胸痛
气急喘息	呼吸	气急
表皮无丘疹心烦眠差	神志	眠差
口干痛	口	口干
发音嘶哑咽干	神志	发音嘶哑
大汗淋漓	皮	大汗淋漓
少腹和睾丸抽搐剧痛	筋	抽搐
整日闷闷不乐	情绪	闷闷不乐
色黄味臭;小便黄少	泌尿生殖	小便黄
咳吐脓痰	运化	吐脓
自汗淋漓	皮	自汗淋漓
胃脘胀气痞闷	腹	胃脘胀气
身体痛困	肉	身体痛
颈项疼痛不适	肉	颈项疼痛
夜间多发胸闷	胸	胸闷
神情烦闷	情绪	烦闷
耳部肿胀	耳	耳肿
皮肤干枯不泽	皮	皮肤干枯
消瘦盗汗	皮	盗汗
并下腹坠胀	腹	下腹坠
经迟	泌尿生殖	经迟
胸痛彻背	胸	胸痛
腰痛疲乏	腰	腰痛
神差便溏	运化	便溏
脣甲色淡	筋	甲色淡
心中烦热	皮	烦热
情绪激动时全身颤抖	筋	全身颤抖
经来腹痛	腹	腹痛
口中常苦	口	口中苦
右胁部隐痛不适	胁	右胁部隐痛
目陷面浮晄	目	目陷
腹中积冷	腹	腹中冷
胸肋窜痛	胸	胸肋痛
脘闷嗳气	运化	嗳气
行走不稳	肉	行走不稳
周身无力	肉	周身无力
经行腹痛.	腹	腹痛
皮肤干燥粗糙	皮	皮肤干燥
左耳间歇性耳鸣	耳	耳鸣
致腹痛经漏	腹	腹痛
头目眩晕	头	头晕
经期腹痛加重	腹	腹痛
口渴大便干	口	口渴
颧赤唇红	口	唇红
左眼突出	目	左眼突出
肌瘦咳嗽	肉	肌瘦
纳差体力差	运化	纳差
右下肢浮肿	皮	右下肢浮肿
颈痠	肉	颈痠
腰痠膝软	腰	腰痠
心悸活动后明显气短	胸	心悸
牙根浮动头晕腰痛	头	头晕
痰多色白咽干口干	咽喉	咽干
齿根血出	骨	齿出血
怕冷腰痛难以俯仰	腰	腰痛
头痛身楚	肉	身楚
手足汗出	皮	汗出
手胀	肉	手胀
目胀昏花	目	目昏花
小腿中段可见大片皮下瘀斑及多个大小不等的张力性水泡	皮	皮下瘀斑
左下肢麻/酸困	皮	下肢麻
目睛赤	目	目睛赤
精神昏沉	神志	神昏沉
头晕而痛	头	头晕
右手掌浮肿	骨	浮肿
口粘腻	口	口粘腻
四肢凉	皮	四肢凉
腹中微胀	腹	腹中胀
步履无力	肉	步履无力
右耳失聪	耳	右耳失聪
骶尾部疼痛	腰	骶尾部疼痛
食后腹胀疼加重	腹	腹胀
左上肢无力	肉	左上肢无力
腹胀满	腹	腹胀满
即面色青黑	皮	面青色
全身震颤	筋	全身震颤
失眠.	神志	失眠
全身发热	皮	全身发热
面色晦黄	皮	面色晦
动则胸闷气急	呼吸	气急
第二日鼻色变黑	鼻	鼻黑
胸痹心痛	胸	心痛
产后头发脱落	皮	头发脱落
四肢皮肤陈旧性紫斑	皮	四肢
发热腹泻	皮	发热
未避孕未孕经期伴下腹坠胀	泌尿生殖	未孕
汗出口臭	口	口臭
伴口臭	口	口臭
偶有胸闷憋气	胸	胸闷
胸闷夜烦	情绪	烦
白睛有赤丝发生	目	白睛赤丝
过午精神差	神志	精神差
头晕目干	目	目干
头痛颊赤	头	头痛
胃脘痛反复发作	腹	胃脘痛
精神淡漠	神志	精神淡漠
惊惧多梦	情绪	惊惧
胃脘隐痛伴胀满不舒反复发作	腹	胃脘隐痛
色红自觉烦躁	情绪	烦躁
腰腿发凉	皮	发凉
腹痛膝软	肉	膝软
头晕耳堵	头	头晕
右膝皮温高	皮	皮温高
时易汗出	皮	汗出
左上腹痛	腹	左上腹痛
左半身出汗	皮	左半身出汗
周身无力 心悸眠差	肉	周身无力
上课嗜睡	神志	嗜睡
错语	神志	错语
语气低微	神志	语气低微
小便量多	泌尿生殖	小便量多
齿龈渗血	骨	齿龈渗血
疲乏气短	肉	疲乏
烧心吞酸	运化	吞酸
便纸常沾附鲜血伴头晕眠差口苦	头	头晕
张口假性强直耳鸣(右)如蝉啸	口	张口
足冷夜尿频多	皮	足冷
大便稀溏不成形	运化	大便稀溏
咳较多黄色粘痰	呼吸	咳
头晕乏力低热	头	头晕
右下肢凉	皮	右下肢凉
指端发凉	皮	发凉
右侧上下肢不能活动	肉	不能活动
胸胁郁闷	情绪	郁闷
腰部怕冷喜温	腰	腰部怕冷
头晕心悸	胸	心悸
右膝左腕活动受限	肉	活动受限
阴痿自汗	泌尿生殖	阴痿
两目赤突	目	两目赤
声重痰多	神志	声重
左腿麻痛	口	麻
眼睑浮肿	皮	眼睑浮肿
右下腹疼痛拒按	腹	右下腹疼痛
耳疼颊赤	皮	颊赤
两胁刺痛及肚里疼	腹	肚腹疼痛
皮肤枯槁粗糙	皮	皮肤枯槁
腰酸溲少	腰	腰酸
腹痛气急	腹	腹痛
乳房发胀	乳房	乳房发胀
便秘尿黄	泌尿生殖	尿黄
丘疹部分丘疹顶端有小脓疱瘙痒口渴喜饮	皮	瘙痒
吐沫抽搐	筋	抽搐
困乏无力	肉	困乏无力
处冷汗	皮	冷汗
语涩	神志	语涩
头眩昏	目	眩
耳鸣如蝉	耳	耳鸣
易心悸	胸	心悸
麻木僵硬感	皮	麻木
伴肛门下坠感	肛门	肛门下坠
面赤齿燥	骨	齿燥
神昏	神志	神昏
身困倦怠	肉	倦怠
偶有头部及四肢麻木	皮	四肢麻木
易汗出	皮	汗出
下半身盗汗	皮	盗汗
身重肢倦	肉	肢倦
发病搐搦	筋	搐搦
头昏倦怠	头	头昏
腰酸寐差	腰	腰酸
两颊部有麻木感	皮	麻木
走路蹒跚欲仆	肉	走路蹒跚
头晕汗出	皮	汗出
有时夜晚多汗	皮	多汗
伴疲倦	肉	疲倦
偶有胸闷气急	胸	胸闷
左耳后及耳中疼痛	耳	耳中疼痛
喘促肢冷	呼吸	喘促
伴周身乏力	肉	周身乏力
神迷	神志	神迷
有血块伴见五心烦热	皮	五心烦热
身痒	皮	身痒
周身怕冷	皮	怕冷
口干舌黑	口	口干
伴心悸气短	胸	心悸
间胃脘隐痛	腹	胃脘隐痛
发动即心中烦躁	情绪	烦躁
乏困欲寐	肉	乏困
左侧肢体稍感麻木	皮	麻木
时有尿血	泌尿生殖	尿血
盗汗失精	皮	盗汗
腹痛绵绵	腹	腹痛
反复出现皮肤出血点伴乏力	肉	乏力
同时出现右胁疼痛	胁	右胁疼痛
肢抖	筋	肢抖
易多虑	情绪	多虑
咳引腹壁疼痛	呼吸	咳
咽干头重	咽喉	咽干
头痛较重	头	头痛
眼珠痛	目	眼珠痛
不能平卧咳嗽咯痰	呼吸	咳嗽
时口苦	口	口苦
嗝气多	运化	嗝气
头晕肢楚	肉	肢楚
脚肿	皮	脚肿
手脚麻痛	皮	手脚麻
哈欠多	神志	哈欠
咳嗽诸肋刺痛	呼吸	咳嗽
精神倦怠乏力	神志	精神倦怠
脱发显	皮	脱发
右侧肾区疼痛	腰	肾区疼痛
心悸动喜忘	胸	心悸动
一边足膝无力	肉	足膝无力
肛门周围突然肿痛,持续加剧	肛门	肛门周围痛
头昏重感	头	头昏
发热便闭	皮	发热
痰结喉中	咽喉	喉痰
不耐多言月经量多	泌尿生殖	月经量多
伴咳黄痰	呼吸	咳
咳嗽腹痛	腹	腹痛
平卧胸闷	胸	胸闷
偶打嗝	运化	打嗝
小便黄偶有热感	泌尿生殖	小便黄
瞳孔散大	目	瞳孔散大
耳聋健忘	耳	耳聋
心烦焦虑头晕	头	头晕
唇咽干燥	咽喉	咽干燥
心痛时作	胸	心痛
目身稍黄尿黄	泌尿生殖	尿黄
面白无华	皮	面白
偶伴恶心	运化	恶心
橘皮样改变神疲乏力	神志	神疲
口干头痛	头	头痛
汗不出	皮	汗不出
多疑善虑	情绪	多疑善虑
气急	呼吸	气急
喘促肢冷	皮	肢冷
异臭粘液便	运化	粘液便
纳呆不渴	口	不渴
冷汗出	皮	冷汗出
伴反胃	运化	反胃
口干小便黄	口	口干
周身皮肤黄染	皮	皮肤黄染
两胁痞塞	胁	胁痞塞
口干便燥	口	口干
以干渴而求饮	口	干渴
腹胀心烦	情绪	心烦
皮肉消瘦	肉	皮肉消瘦
远年近日眼目昏花	目	眼目昏花
阴毛脱落	皮	阴毛脱落
大人小儿疳齿宣露	骨	齿宣
胸部微汗	皮	胸部微汗
腹肚紧张	腹	腹紧张
足心痒	皮	痒
并伴左小腿外侧疼痛	肉	左小腿外侧疼痛
呃声连连	运化	呃
右眉上抬无力	肉	无力
寒冷季节胃脘痛	皮	寒冷
大便溏.腹部隐痛	运化	大便溏
面色青葩	皮	面青色
身热心烦	情绪	烦
口干欲饮.	口	口干
食后脘腹痛	腹	脘腹痛
入夜盗汗	皮	盗汗
乏力懒言	肉	乏力
伴汗出	皮	汗出
肢体痠困	肉	肢体痠
多梦大便偏干	神志	多梦
自汗口噤	口	口噤
左颞头痛阵作	头	头痛
间断呃逆	运化	呃逆
面部疼痛	肉	面部疼痛
身痛鼻塞	鼻	鼻塞
咳黄色浊痰	呼吸	咳
面色青晦	皮	面色青
胸膈嘈杂	运化	胸膈嘈
皮肤干涩	皮	皮肤干涩
溲频	泌尿生殖	溲频
夜寐欠佳	神志	夜寐欠佳
腹部发冷	皮	发冷
中风四肢掣疭	筋	肢掣
面赤口张	口	口张
其腹坚实	腹	腹坚实
面部麻木中度	皮	面部麻木
神疲.便溏	运化	便溏
指纹偏红	脉	指纹红
形怯畏寒	皮	畏寒
黄色稀水便	运化	稀水便
汗出殊多	皮	汗出
抽搐汗出	筋	抽搐
心烦盗汗	情绪	心烦
右足麻木	皮	足麻木
经脉滞涩	脉	脉滞涩
心痛及腹痛	腹	腹痛
腰痠头晕	腰	腰痠
患者腰痛	腰	腰痛
肢冷乏力	皮	肢冷
胸闷短气神疲乏力	胸	胸闷
有时打呃	运化	打呃
左侧口周面部和左手麻木不适倦怠乏力	肉	倦怠乏力
喉间哮鸣	咽喉	喉间哮鸣
口渴纳差舌质红	舌	舌质红
头疼体痛	肉	体痛
经期腹痛腰痛	腰	腰痛
呼吸不畅	呼吸	呼吸不畅
空腹嘈杂	运化	嘈杂
触摸四肢皮肤反应迟钝	神志	反应迟钝
咳嗽喘憋	呼吸	咳嗽
腹胀矢气	腹	腹胀
大腹膨胀	腹	大腹膨胀
疲惫乏力	肉	疲惫乏力
产妇乳汁不通	乳房	乳汁不通
夜间时发心悸	胸	心悸
左臂疼痛	肉	左臂疼痛
咳白粘痰	呼吸	咳
胃脘及两胁撑胀	胁	胁撑
鼻孔流血	鼻	鼻孔流血
目涩头晕	目	目涩
胃热	腹	胃热
精神郁闷	情绪	精神郁闷
自觉上部发热	皮	发热
肌瘦自汗	肉	肌瘦
稍头痛	头	头痛
麻木酸楚	皮	麻木
心烦头痛	头	头痛
全身红丘疹	皮	全身红
腰痠困	腰	腰痠
下蹲费力右眼视力丧失	目	视力丧失
咽喉干	咽喉	咽喉干
见行走困难	肉	行走困难
腰腹隐痛	腰	腰隐痛
打喷嚏及流清涕	鼻	流清涕
觉脑中昏愦	头	脑中昏愦
面肢肿	皮	面肢肿
困倦无力	肉	困倦无力
过劳则厌食	运化	厌食
发歇搐搦	筋	搐搦
腹胀不和	腹	腹胀
肛门肿疼	肛门	肛门疼
吐之不出	运化	吐
汗下后又加大吐	运化	吐
胸闷憋气胆小	胸	胸闷
大便泄下不止	运化	大便泄
右侧肢体活动障碍	肉	肢体活动障碍
足寒背痛	肉	背痛
烦躁脉紧而弦	情绪	烦躁
咳中带血	呼吸	咳
流鼻涕	鼻	流鼻涕
腰骶酸沉平素带下色白	腰	腰骶酸
入夜梦多	神志	梦多
视力丧失	目	视力丧失
面色黄白	皮	面色黄
鼻涕带血	泌尿生殖	带血
食后脘痞	腹	脘痞
后背酸楚疼痛发凉	皮	发凉
体骨疼痛	肉	体疼痛
皮肤干枯	皮	皮肤干枯
时时思睡	神志	思睡
经行乏力	肉	乏力
失眠早醒	神志	失眠
下肢时肿	骨	肿
胸中满闷	胸	胸中满闷
恶风少气	皮	恶风
后背及小腹疼痛	腹	小腹疼痛
胸前区发热发闷	皮	发热
双眼脸及双下肢浮肿	皮	双下肢浮肿
述头晕乏力	头	头晕
伴左少腹疼痛	腹	少腹疼痛
发作时以胸闷为主	胸	胸闷
麻木疼痛	皮	麻木
结婚3年不孕	泌尿生殖	不孕
晨起刷邪泛恶	运化	泛恶
性欲减退	泌尿生殖	性欲减退
小水频	泌尿生殖	小水频
视一为二	目	视一为二
下肢痠困	肉	下肢痠
现自觉右侧腰腹胀	腹	腹胀
胸中寒	胸	胸冷
右上腹隐疼	腹	腹隐疼
咳痰量多耳堵	呼吸	咳痰
小便淋漓欠畅	泌尿生殖	小便淋漓
神疲倦怠	神志	神疲倦怠
咽干不舒	咽喉	咽干
凌晨全身出汗	皮	出汗
胸闷如裹	胸	胸闷
反胃呕吐	运化	呕吐
小腹冷隐作痛	腹	小腹冷
口鼻发干不渴	口	不渴
手脚怕冷	皮	怕冷
肤色黯而微紫	皮	肤色黯
咳少量粘液痰	呼吸	咳
腹部膨胀	腹	腹部膨胀
手心自觉发热	皮	发热
胁肋苦痛	胁	肋胁痛
口苦舌粗	舌	舌粗
小腹痛神疲乏力	神志	神疲
耳痒	耳	耳痒
怕冷也怕热体丰	肉	体丰
感头晕	头	头晕
口臭肢热	口	口臭
心烦颊赤	皮	颊赤
已漏红一周余	生殖器	漏红
小便短频	泌尿生殖	小便短
嗳气有馊腐味	运化	嗳气
腹中胀满欲死	腹	腹中胀满
阴痿阴汗	皮	阴汗
颈项强拘紧	筋	颈项强
双脚发热	皮	发热
脐周胀疼	腹	脐周胀
腹痛胀	腹	腹痛
皮肤僵硬	皮	皮肤僵硬
耳鸣面黧黯	皮	面黧
声音低怯	神志	声音低怯
劳累或激动时胸痛	胸	胸痛
频发挤眉弄眼	目	挤眉弄眼
背脊拘急冷痛	筋	背脊拘急
咳漱	呼吸	咳
食后脘满	腹	脘满
胸闷胃胀平素偶见情绪低落	胸	胸闷
重耳不闻人声	耳	耳不闻
身热骨酸	皮	身热
不眠	神志	不眠
鼻塞眼昏	目	眼昏
产后周身疼痛	肉	周身疼痛
小便色深如茶.口渴	口	口渴
足冷过膝	皮	足冷过膝
动则气喘	呼吸	气喘
食后腹胀重	腹	腹胀
肢体浮肿	皮	肢体浮肿
嗳气酸腐	运化	嗳气
口干多梦	口	口干
头晕倦怠	肉	倦怠
脑热烦闷	头	脑热
眼痛而憎寒	目	眼痛
肛门抽痛下坠	筋	抽
疲劳嗜睡	肉	疲劳
脘痞纳呆	运化	纳呆
进食梗阻	运化	进食梗阻
爪甲皆青	筋	爪甲青
彻夜不寐.	神志	彻夜不寐
声低	神志	声低
神疲身困	神志	神疲
痰吐稠粘	运化	吐
平素畏寒甚	皮	畏寒
脘痞胀痛恶心	腹	脘痞
求饮喜冷	皮	冷
后背痛	肉	后背痛
小便黄短而赤	泌尿生殖	小便黄
反复双下肢浮肿	皮	双下肢浮肿
阴道出血量时多时少	生殖器	阴道出血
指纹浮而显露	脉	指纹浮
口不仁面垢	口	口不仁
时耳鸣口干	口	口干
高热	皮	高热
腰痛伴晨僵	腰	腰痛
尿不净	泌尿生殖	尿不净
头摇口噤	口	口噤
消谷善饥而多尿	运化	消谷善饥
咳嗽咯白痰	呼吸	咳嗽
口干粘	口	口干
烦热面烘	皮	烦热
每至天明汗出热退	皮	汗出
口干舌缩	舌	舌缩
尿黄舌质红	泌尿生殖	尿黄
频频呕吐	运化	呕吐
入睡洗澡时瘙痒最明显	皮	瘙痒
下腹坠胀	腹	下腹坠
牙根溃烂出血	骨	牙根出血
巅顶及右侧偏头痛	头	右侧偏头痛
有时精神不振	神志	精神不振
出汗气喘	皮	出汗
口粘而苦	口	口粘
眼目疼肿	目	目疼
右下肢肿凹陷性	皮	右下肢肿
排便不爽	运化	排便不爽
女子前阴漫肿	生殖器	前阴肿
偶有下肢无力	肉	下肢无力
胃脘部胀满嗳气.	腹	胃脘部胀满
头晕气短	呼吸	气短
神疲气短	神志	神疲
胃脘痞胀	腹	胃脘痞胀
口唇紫暗或暗红	口	口唇紫
时有脑鸣	耳	脑鸣
咽喉胀紧	咽喉	喉紧
上腹部胀	腹	上腹部胀
夜间汗出多	皮	汗出
时有咽干	咽喉	咽干
四肢少动	皮	四肢
小便色微黄	泌尿生殖	小便色微黄
头痛身烧	皮	身烧
月事先期	泌尿生殖	月事先期
不思饮食	运化	不思饮食
羸瘦骨热	肉	羸瘦
腹中觉有冷气一裹直冲而上	腹	腹中冷气
闭目常	目	闭目
四肢时有抽痛	皮	四肢
张口假性强直耳鸣(右)如蝉啸	耳	耳鸣
口淡干呕	运化	干呕
凌晨2-3时咳吐大量白痰	呼吸	咳
鼻衄反复	鼻	鼻衄
胃脘胀闷不舒	腹	胃脘胀闷
颈项转动时头昏加重	头	头昏
四肢抽搐	筋	四肢抽搐
消化不良食少	运化	食少
骨蒸羸瘦	肉	羸瘦
间断性咳嗽	呼吸	咳嗽
头晕口渴	口	口渴
胃热消谷	运化	消谷
现疲乏	肉	疲乏
月经未行	泌尿生殖	月经未行
经行腹痛伴量多	腹	腹痛
右足背外侧麻木感	皮	麻木
倦怠眠差	肉	倦怠
矢气奇臭	运化	矢气
手麻木	皮	手麻木
产妇气乏难产	泌尿生殖	难产
瘙痒难忍	皮	瘙痒
头空痛	头	头空
肉眼血尿	泌尿生殖	血尿
口噤吐沫	神志	吐沫
阵发性呼吸困难	呼吸	呼吸困难
左少腹部疼痛	腹	少腹部疼痛
伴有微咳	呼吸	咳
面色萎黄晦暗	皮	面色萎黄
不欲饮水	口	不欲饮水
肠鸣后腹泻	腹	肠鸣
发作性四肢抽搐	筋	四肢抽搐
大便稀泄	运化	大便稀
心悸少寐	神志	少寐
鼻衄	鼻	鼻衄
颈背痛	肉	背痛
著惊发热	情绪	发惊
白带色黄质稠	泌尿生殖	白带色黄
头痛腰疼	头	头痛
两肋胀少气力	胁	两肋胀
眠差易惊醒	神志	眠差
腿冷	皮	腿冷
多食腹胀	腹	腹胀
胸憋闷痛	胸	胸憋闷
目红	目	目红
鼻腔干燥	鼻	鼻腔干燥
口渴纳差舌质红	口	口渴
口干时欲呕	口	口干
气短神倦	呼吸	气短
胸闷且痛	胸	胸闷
腰痛隐隐	腰	腰痛
食纳减少	运化	食纳减少
气喘颊赤	呼吸	气喘
精神不振.	神志	精神不振
腹胀便溏.	运化	便溏
且腥臭烦热	皮	烦热
流泪鼻干无涕	目	流泪
日晚口干颊赤	口	口干
打嗝频频	运化	打嗝
喉肿心痛	胸	心痛
皮温升高	皮	皮温升高
取环后4年多不孕	泌尿生殖	不孕
腹痛呕吐	腹	腹痛
攻皮肤刺痛	皮	皮肤刺痛
低热头昏痛	皮	低热
伴腰痛怯冷	腰	腰痛
左下肢活动受限	肉	左下肢活动受限
四肢困倦	肉	四肢困倦
伴心情郁闷	情绪	心情郁闷
右下眼睑右口角不自主地抽动	筋	抽动
朝食暮吐	运化	吐
胸隔满闷	胸	胸闷满
令人脑痛齿亦痛	头	脑痛
咳痰量少	呼吸	咳痰
口噤目闭	口	口噤
感呼吸困难	呼吸	呼吸困难
舌质黯	舌	舌质黯
头晕脚软	头	头晕
痛处略肿	骨	肿
性情躁急.	情绪	性情躁急
咽喉气噎塞成气瘿	咽喉	咽喉气噎
脉来洪	脉	脉洪
气短无力	肉	无力
心悸心烦	胸	心悸
口燥咽干	咽喉	咽干燥
面黄无华	皮	面黄
劳累后腹股沟及小腹坠痛	腹	小腹坠
脾气烦躁	情绪	烦躁
因精神紧张引起恶心	运化	恶心
心慌阵发性发作	胸	心慌
左足背部疼痛	肉	背部疼痛
胸闷痛憋气	呼吸	憋气
脑昏目疼	目	目疼
口噤胸满	胸	胸满
活动后及汗出时咳嗽	皮	汗出
胸痞腰酸	腰	腰酸
泛酸反复发作	运化	泛酸
两胁搐急作痛	筋	搐
眼目不清	目	目不清
左侧胸闷	胸	胸闷
睁开无力	肉	无力
头目胀痛	头	头痛
胃恶性间质瘤术后乏力明显	肉	乏力
夜间入睡困难	神志	入睡困难
醒后自汗	皮	自汗
吞咽正常鼻腔作痒咽头稍干感胸膺痞闷	胸	胸膺痞闷
久则面黄肌瘦	皮	面黄
舌苔少	舌	舌苔少
乏力困倦	肉	乏力困倦
呃酸	运化	呃
感双下肢无力	肉	双下肢无力
精冷	皮	冷
腿痛	肉	腿痛
腹部隐痛	腹	腹部隐痛
食入腹胀加重	腹	腹胀
嗜睡甚至昏睡	神志	嗜睡
皮肤黄染	皮	皮肤黄染
抽搐	筋	抽搐
头晕耳鸣健忘	耳	耳鸣
双下肢酸胀感	肉	双下肢酸
口干舌刺	舌	舌刺
伤寒头痛壮热	头	头痛
指凉	皮	指凉
时有下肢颤动	筋	下肢颤动
渴欲饮水	口	渴
头痛1年	头	头痛
小便灼热感	泌尿生殖	小便灼热
头目眩晕	目	目眩
足背浮肿	骨	浮肿
伴有胃脘痞满不舒	腹	胃脘痞满
关节痛,体温增高	骨	关节痛
齿动目昏	骨	齿动
面色萎黄不华	皮	面色萎黄
纳呆乏力左胸前疼痛	肉	乏力
腹胀便闭	运化	便闭
双下肢麻木乏力	肉	乏力
腰痛伴下肢水肿	腰	腰痛
干呕	运化	干呕
乏力多汗	肉	乏力
小儿脾弱面青	皮	面青
面色萎黄乏力	皮	面色萎黄
时见肉眼血尿	泌尿生殖	血尿
纳寐差	神志	寐差
咳痰后减轻	呼吸	咳痰
咳痰黄	呼吸	咳痰
头晕多寐	神志	多寐
症见脘腹闷胀	腹	脘腹闷胀
产妇乳汁不行	乳房	乳汁不行
右小腿疼痛	肉	右小腿疼痛
饮食睡眠不佳	神志	睡眠不佳
郁闷	情绪	郁闷
腰痛崩漏	泌尿生殖	漏尿
胃脘部胀满嗳气.	运化	嗳气
经期错乱	泌尿生殖	经期错乱
泄泻盗汗	皮	盗汗
高热神疲	神志	神疲
痰鸣气粗	咽喉	痰鸣
面赤心烦	情绪	烦
胸膈结热	胸	胸膈热
疼痛明显伴口苦	口	口苦
口唇或齿龈紫暗	口	唇紫
